#####################
#     # #     #   # #
### # # ### # ### # #
#   # #     #   #   #
### ### ########### #
# # # #   #   # #   #
# # # # # # ### # # #
# # #   #   # #   # #
# # ### ##### ##### #
#       #       # # #
# ##### # # ##### # #
# #   #   #   #     #
### ### # # ##### ###
# # #   # #     #   #
# # # # ##### # ### #
# #   # #   # #     #
# # ### # # ### # ###
#   # # # # #   # # #
### # # # ####### # #
#   #     #         #
#####################