###############
#             #
# # # ### ### #
# # # # # # # #
##### # ### # #
#       #     #
# ### # ### # #
#   # # # # # #
### ### # # ###
#   #   #     #
# ##### ### ###
#     #   # # #
### # # ##### #
#   # #       #
###############