#############
#   #   # # #
# ### ### # #
#   # #     #
# ### ### ###
#     #     #
### ##### ###
# #     # # #
# # # ### # #
#   #   # # #
### # # # # #
#   # #     #
#############