#################
#       #   #   #
# ### ##### # # #
# # # # #     # #
# # # # ### ### #
# #     #   #   #
##### ####### # #
# # #   # # # # #
# # # # # # # ###
# #   #       # #
# # ### # ##### #
#   # # #       #
##### # # # ### #
# #   # # #   # #
# ### ### #######
#               #
#################