###########
#     #   #
##### ### #
# # #     #
# # ##### #
#     #   #
### # # # #
#   #   # #
####### # #
#       # #
###########