*********************
*                 * *
* ***** * *** *** * *
* *     * *   *   * *
* ******* *** ***** *
*     *   * *       *
*** * * * * * * *****
* * * * * *   * *   *
* * * ***** ******* *
*   * * *       *   *
*** *** ******* * * *
* *   *   *       * *
* * * * ********* ***
*   *     * * *   * *
***** * *** * ***** *
*     * *           *
*** *** ******* * ***
* * *     *     * * *
* * * *** * *** * * *
*   *   *   *   *   *
*********************