****************
*        *     *
*  ****  *  *  *
*     *  *  *  *
*******  *  ****
*  *  *     *  *
*  *  ****  *  *
*     *  *     *
*  ****  *  ****
*              *
****************