**********************
*        *  *  *     *
****  *  *  *  *  *  *
*  *  *  *     *  *  *
*  ****  *  ****  *  *
*           *     *  *
*  *******  ****  ****
*        *           *
*  *******  *  *  ****
*  *        *  *  *  *
*******  *  ****  *  *
*        *     *     *
**********  *  ****  *
*           *     *  *
**********************