*************************
*  *                    *
*  **********  *******  *
*           *        *  *
*  ****************  *  *
*     *     *  *     *  *
*  ****  *  *  *******  *
*        *     *        *
*  ****  **********  ****
*     *        *  *  *  *
****  **********  *  *  *
*     *  *  *        *  *
*  ****  *  *  *******  *
*     *        *  *     *
*  *******  *  *  *  ****
*           *           *
*************************