*******************
*        *  *     *
*  *******  *  *  *
*     *        *  *
*  ****  ****  *  *
*  *  *  *     *  *
*  *  ****  ****  *
*  *        *  *  *
*  *  ****  *  *  *
*        *  *     *
*  *  *  *  ****  *
*  *  *  *  *     *
*******************